[锚头鳋病]是由什么引起的	病因
造成[中华鳋病]的原因	病因
[坏瘟性肺炎]的疾病类型是什么	类型
造成[腐鳍病]的原因	病因
[四极虫病]的病原是什么	病因
[羊虱虫病]属于什么病	类型
[鲤长棘吻虫病]主要引起什么	症状
[喜树]含有有毒的什么	有毒成分
患上[侧殖吸虫病]会产生什么症状	症状
[鲢碘泡虫病]的病因多为什么	病因
[变形虫病]容易出现什么	症状
[高梁二茬苗]含毒性的部分是什么	有毒成分
[禽巴氏杆菌病]属于什么类型	疾病分类
[刺槐]什么成分有毒	有毒成分
[膀胧麻痹]是什么类型的疾病	类型
[中华鳋病]的病原是什么	病因
[鲤蠢绦虫病]主要引起什么	症状
[蚜虫]的别称是什么	别名
[鲤长棘吻虫病]伴随着什么出现	症状
造成[黏体虫病]的原因	病因
[鲤长棘吻虫病]主要症状是什么	症状
[毒蛋白]因此称什么	别名
[侧殖吸虫病]主要表现出什么	症状
[肠炎]的类型是什么	类型
[高梁二茬苗]有毒是因为含有什么	有毒成分
[灰灰菜]俗称什么	别名
[贫血]的类型是什么	类型
[鳗赤鳍病]是什么引起的疾病	病因
[毒蛋白]又叫	别名
[腹膜炎]属于什么病	类型
[紫茎泽兰]又称	别名
[狭腹鳋病]的病因多为什么	病因
[荞麦]有毒是因为含有什么	有毒成分
[侧殖吸虫病]可能引起什么	症状
[青冈]含毒性的部分是什么	有毒成分
请问[大叶性肺炎]的类型	类型
[毒蛋白]含有有毒的什么	有毒成分
[鲤蠢绦虫病]是什么导致的	病因
[球状鳗居线虫病]是什么导致的	病因
[瓣胃阻塞]是什么	类型
[桃树]含毒性的部分是什么	有毒成分
[贫血]属于什么病	类型
[高梁二茬苗]含有有毒的什么	有毒成分
[土豆]又叫什么	别名
[中华鳋病]是什么导致的	病因
[棘衣虫病]的病原是什么	病因
[食毛症]是一种什么疾病	类型
[球状鳗居线虫病]是由什么引起的	病因
[紫云英]的别称是什么	别名
[鱼病]的病因多为什么	病因
[液膜性肠炎]俗称什么	别名
[除血捻转胃虫病]又称	别名
[钩虫病]又称	别名
[创伤性心包炎]的类型	类型
[微孢子虫病]的病原是什么	病因
[子宫内膜炎]是一种什么疾病	类型
[刺槐]含有什么	有毒成分
[胸膜炎]的疾病类型是什么	类型
造成[球状鳗居线虫病]的原因	病因
[血红蛋白尿]就患病部位来说属于什么类型的疾病	类型
[荞麦]含有什么	有毒成分
[蛀鳍烂尾病]是由什么引起的	病因
[贫血]是一种什么疾病	类型
[棘豆]什么成分有毒	有毒成分
[青冈]含有有毒的什么	有毒成分
[瓣胃阻塞]属于什么病	类型
[棘衣虫病]有什么特征	症状
[禽大肠杆菌病]临床上可以分为什么常见的	疾病分类
[侧殖吸虫病]主要表现为	症状
[棘衣虫病]会有什么样的情况	症状
[刺槐]什么成分毒性最强	有毒成分
[胸膜炎]是什么	类型
[土豆]又被称为什么	别名
[灰灰菜]的别称是什么	别名
请问[口腔炎]的类型	类型
[大叶性肺炎]的类型	类型
[鳗赤鳍病]是由什么引起的	病因
[中华鳋病]的病因是什么	病因
[蜡梅]有毒成分是什么	有毒成分
[羊虱虫病]的疾病类型是什么	类型
[闹羊花]的俗称是什么	别名
[口腔炎]的类型	类型
[断肠草]的俗称是什么	别名
[侧殖吸虫病]是由什么引起的	病因
[棘豆]又叫什么	别名
[倭病]就患病部位来说属于什么类型的疾病	类型
[醉马草]含有有毒的什么	有毒成分
[血居吸虫病]是由什么引起的	病因
[结节虫病]的俗称是什么	别名
[夹竹桃]什么成分毒性最强	有毒成分
[青草搐搦]属于什么类型的疾病	类型
[霉菌性肠炎]属于什么病	类型
[真菌]什么成分有毒	有毒成分
[羔羊水中毒]是一种什么疾病	类型
[刺槐]又叫	别名
[鲤蠢绦虫病]是什么导致的	病因
[变形虫病]有什么症状	症状
[肠炎]的类型	类型
[钻缺乏症]的类型	类型
就患病部位来说[羊虱虫病]是什么类型的疾病	类型
就患病部位来说[产后感染]是什么类型的疾病	类型
[毒芹]有毒是因为含有什么	有毒成分
[玉米]有毒成分是什么	有毒成分
[子宫内膜炎]属于什么病	类型
[青冈]的俗称是什么	别名
[紫茎泽兰]的俗称是什么	别名
请问[羔羊痢]的类型	类型
[刺槐]因此称什么	别名
[喉炎]是什么	类型
[子宫内膜炎]的疾病类型是什么	类型
[锚头鳋病]的病原是什么	病因
[醉马草]什么成分有毒	有毒成分
[瘤胃积食]又叫	别名
[萱草]因此称什么	别名
[变形虫病]总的特征是什么	症状
[创伤性网胃炎]因此称什么	别名
[高梁二茬苗]有毒成分是什么	有毒成分
[膀胧麻痹]的类型	类型
[线麻]因此称什么	别名
[节节草]含有什么	有毒成分
请问[霉菌性肠炎]的类型	类型
[线麻]又叫什么	别名
[萱草]又叫	别名
[蚜虫]是什么	别名
[土豆]有毒是因为含有什么	有毒成分
[锚头鳋病]的病因多为什么	病因
[灰灰菜]含有有毒的什么	有毒成分
[腹水]属于什么病	类型
[蒺藜]因此称什么	别名
[棘衣虫病]会引起什么症状	症状
[刺槐]又称	别名
大量感染[棘衣虫病]是会出现什么	症状
[鳗赤鳍病]的病因是什么	病因
[瓣胃阻塞]的类型	类型
[棘豆]又叫	别名
[腹水]的类型	类型
[蕨菜]有毒是因为含有什么	有毒成分
[脑膜脑炎]的疾病类型是什么	类型
[土豆]的别名是什么	别名
就患病部位来说[羊鼻蝇蛆病]是什么类型的疾病	类型
[口炎]又称	别名
[棘豆]有毒成分是什么	有毒成分
[变形虫病]会有什么特点	症状
[子宫内膜炎]的类型	类型
[子宫内膜炎]的类型是什么	类型
[草木樨]又叫	别名
[黄颡似子宫线虫病]的病原是什么	病因
[鲫嗜子宫线虫病病]的病因是什么	病因
[眼角膜炎]属于什么病	类型
[肠炎病]是什么导致的	病因
[鲤长棘吻虫病]的临床症状是什么	症状
[闹羊花]又叫什么	别名
[尿石症]是什么	类型
[羔羊水中毒]属于什么病	类型
[青冈]的别名是什么	别名
造成[狭腹鳋病]的原因	病因
就患病部位来说[羔羊水中毒]是什么类型的疾病	类型
[侧殖吸虫病]伴随着什么出现	症状
[青冈]又称	别名
[膀胧麻痹]是一种什么疾病	类型
[血居吸虫病]的病原是什么	病因
[紫茎泽兰]又叫	别名
[夹竹桃]有毒是因为含有什么	有毒成分
[侧殖吸虫病]发病后会怎么样	症状
[鲤长棘吻虫病]是由什么引起的	病因
[变形虫病]以什么为特征	症状
[产后感染]的类型是什么	类型
[断肠草]又称	别名
[萱草]的别名是什么	别名
[断肠草]的别称是什么	别名
[侧殖吸虫病]的特点是什么	症状
[倭病]是什么类型的疾病	类型
[灰灰菜]是什么	别名
[中暑]的类型	类型
[鲤长棘吻虫病]是什么导致的	病因
[口腔炎]的疾病类型是什么	类型
[蚜虫]俗称什么	别名
造成[蛀鳍烂尾病]的原因	病因
[尿石症]属于什么类型的疾病	类型
[球状鳗居线虫病]的病因多为什么	病因
[黄颡似子宫线虫病]是什么导致的	病因
[癫瘸]属于什么病	类型
[灰灰菜]的别名是什么	别名
[刺槐]的别名是什么	别名
[土豆]因此称什么	别名
[侧殖吸虫病]以什么为特征	症状
[棘豆]俗称什么	别名
[腹水]是什么类型的疾病	类型
[变形虫病]表现为什么	症状
[鲤长棘吻虫病]主要以什么为主	症状
[食道阻塞]的俗称是什么	别名
[变形虫病]可能会怎么样	症状
[棉花叶]什么成分毒性最强	有毒成分
[食毛症]属于什么病	类型
[刺槐]的别称是什么	别名
[黏体虫病]的病原是什么	病因
[草木樨]又被称为什么	别名
[蓖麻]什么成分毒性最强	有毒成分
[紫茎泽兰]又叫什么	别名
[土豆]的俗称是什么	别名
[线麻]是什么	别名
[断肠草]是什么	别名
[菜子饼]有毒是因为含有什么	有毒成分
[皱胃右方变位]因此称什么	别名
[断肠草]又叫什么	别名
[烂鳃病]的病原是什么	病因
[真菌]有毒是因为含有什么	有毒成分
[烂鳃病]是什么导致的	病因
[奶牛嗣病]的类型是什么	类型
[毒蛋白]的俗称是什么	别名
[产后感染]就患病部位来说属于什么类型的疾病	类型
[变形虫病]会引起什么症状	症状
[萱草]是什么	别名
[肠炎病]的病原是什么	病因
[鱼病]是由什么引起的	病因
[腹水]是一种什么疾病	类型
[刺槐]是什么	别名
[鲤蠢绦虫病]可以看到什么	症状
[创伤性心包炎]的类型是什么	类型
[鲤长棘吻虫病]容易出现什么	症状
[蕨菜]含有有毒的什么	有毒成分
[闹羊花]含毒性的部分是什么	有毒成分
[肠炎]属于什么病	类型
[线麻]什么成分毒性最强	有毒成分
就患病部位来说[肾炎]是什么类型的疾病	类型
[羊虱虫病]属于什么类型的疾病	类型
[尾孢虫病]是由什么引起的	病因
[夹竹桃]含毒性的部分是什么	有毒成分
[闹羊花]又称	别名
[蛀鳍烂尾病]的病原是什么	病因
[马颈鱼鯴病]的病因是什么	病因
[水霉病]是什么引起的疾病	病因
大量感染[侧殖吸虫病]是会出现什么	症状
[鲤蠢绦虫病]的病原是什么	病因
[侧殖吸虫病]呈现出什么	症状
造成[烂鳃病]的原因	病因
[侧殖吸虫病]的病因是什么	病因
[萱草]又叫什么	别名
[土豆]又称	别名
[萱草]的别称是什么	别名
[侧殖吸虫病]会出现什么	症状
[土豆]的别称是什么	别名
[羊虱虫病]就患病部位来说属于什么类型的疾病	类型
请问[青草搐搦]的类型	类型
[高梁二茬苗]什么成分有毒	有毒成分
[棘豆]有毒是因为含有什么	有毒成分
[液膜性肠炎]又被称为什么	别名
[巴圆白菜]含有什么	有毒成分
[菜子饼]含有什么	有毒成分
[风湿症]属于什么类型的疾病	类型
[蚜虫]又叫什么	别名
[狭腹鳋病]的病原是什么	病因
[羔羊癫痫]就患病部位来说属于什么类型的疾病	类型
[肾炎]是什么类型的疾病	类型
[霉菌性肠炎]的疾病类型是什么	类型
[紫茎泽兰]含有什么	有毒成分
[血红蛋白尿]是一种什么疾病	类型
[低镁血症]俗称什么	别名
[禽巴氏杆菌病]的类型是什么	疾病分类
[醉马草]有毒成分是什么	有毒成分
[蓖麻]有毒是因为含有什么	有毒成分
[支气管炎]就患病部位来说属于什么类型的疾病	类型
请问[支气管炎]的类型	类型
[狭腹鳋病]是由什么引起的	病因
[侧殖吸虫病]表现为什么	症状
[灰灰菜]有毒成分是什么	有毒成分
[鲤长棘吻虫病]发病后会怎么样	症状
[紫云英]含有有毒的什么	有毒成分
[微孢子虫病]是由什么引起的	病因
[钻缺乏症]是什么类型的疾病	类型
[山羊脊髓丝虫病]的俗称是什么	别名
[断肠草]俗称什么	别名
[车轮虫病]是由什么引起的	病因
[鲤蠢绦虫病]致使什么	症状
请问[奶牛嗣病]的类型	类型
[蓖麻]含有什么	有毒成分
[土豆]是什么	别名
[复口吸虫病]是由什么引起的	病因
造成[鲤蠢绦虫病]的原因	病因
[鳗赤鳍病]是什么导致的	病因
[蕨菜]含有什么	有毒成分
[尿石症]属于什么病	类型
[肠炎病]的病因多为什么	病因
患上[棘衣虫病]会产生什么症状	症状
请问[产后感染]的类型	类型
[胰管吸虫病]因此称什么	别名
[鲤长棘吻虫病]呈现出什么	症状
[蚜虫]又称	别名
[钩虫病]的别名是什么	别名
[喜树]什么成分毒性最强	有毒成分
造成[车轮虫病]的原因	病因
[青冈]什么成分有毒	有毒成分
[土豆]又叫	别名
请问[坏瘟性肺炎]的类型	类型
[膀脱炎]是什么	类型
[侧殖吸虫病]会出现什么病症	症状
[棘衣虫病]主要表现为	症状
[巴圆白菜]什么成分毒性最强	有毒成分
[羔羊水中毒]的疾病类型是什么	类型
[禽大肠杆菌病]有什么	疾病分类
[侧殖吸虫病]在病因作用下可能会	症状
[紫云英]有毒是因为含有什么	有毒成分
造成[锚头鳋病]的原因	病因
[青冈]又叫什么	别名
[低镁血症]又被称为什么	别名
[紫云英]有毒成分是什么	有毒成分
[青草搐搦]属于什么病	类型
[线麻]又称	别名
[蒺藜]的别称是什么	别名
[山羊脊髓丝虫病]是什么	别名
[鲤蠢绦虫病]易出现什么	症状
[闹羊花]是什么	别名
大量感染[变形虫病]是会出现什么	症状
[青冈]俗称什么	别名
[蛀鳍烂尾病]是什么导致的	病因
[坏瘟性肺炎]就患病部位来说属于什么类型的疾病	类型
[节节草]什么成分有毒	有毒成分
[细颈囊尾蚴病]的俗称是什么	别名
[指环虫病]的病原是什么	病因
[霉菌性肠炎]是一种什么疾病	类型
[禽巴氏杆菌病]临床上可以分为什么常见的	疾病分类
[膀胧麻痹]的疾病类型是什么	类型
[喉炎]就患病部位来说属于什么类型的疾病	类型
患上[鲤蠢绦虫病]会产生什么症状	症状
[棘豆]含有什么	有毒成分
造成[马颈鱼鯴病]的原因	病因
[紫云英]什么成分毒性最强	有毒成分
[蛀鳍烂尾病]的病因是什么	病因
就患病部位来说[皱胃炎]是什么类型的疾病	类型
[草木樨]又叫什么	别名
[瓣胃阻塞]又称	别名
[风湿症]属于什么病	类型
[喉炎]属于什么类型的疾病	类型
[棘豆]又被称为什么	别名
[草木樨]的别称是什么	别名
[尾孢虫病]的病原是什么	病因
造成[肠炎病]的原因	病因
[线麻]有毒成分是什么	有毒成分
[毒芹]含有什么	有毒成分
[蚜虫]因此称什么	别名
[腐鳍病]的病原是什么	病因
[球状鳗居线虫病]的病因是什么	病因
[棘衣虫病]的特征是什么	症状
[禽大肠杆菌病]的类型是什么	疾病分类
[瓣胃阻塞]的疾病类型是什么	类型
就患病部位来说[大叶性肺炎]是什么类型的疾病	类型
[子宫内膜炎]就患病部位来说属于什么类型的疾病	类型
[羔羊水中毒]的类型	类型
[子宫内膜炎]属于什么类型的疾病	类型
[青冈]因此称什么	别名
[坏瘟性肺炎]是什么类型的疾病	类型
[棘豆]因此称什么	别名
[桃树]有毒是因为含有什么	有毒成分
[霉菌性肠炎]是什么	类型
[萱草]是什么	别名
[鲤蠢绦虫病]在病因作用下可能会	症状
[巴圆白菜]含毒性的部分是什么	有毒成分
[鲤长棘吻虫病]的病原是什么	病因
[青草搐搦]就患病部位来说属于什么类型的疾病	类型
造成[鱼类爆发性出血病]的原因	病因
造成[弧菌病]的原因	病因
[山羊皮肤组织细胞瘤病]是什么类型的疾病	类型
造成[鲤蠢绦虫病]的原因	病因
[紫杉]什么成分毒性最强	有毒成分
[鲤蠢绦虫病]可能会怎么样	症状
[闹羊花]的别名是什么	别名
[变形虫病]易出现什么	症状
[棘衣虫病]是什么导致的	病因
[创伤性心包炎]属于什么病	类型
[侧殖吸虫病]的临床表现为什么	症状
[鲢碘泡虫病]的病因是什么	病因
[尿石症]是一种什么疾病	类型
[线麻]含有什么	有毒成分
[狭腹鳋病]是什么导致的	病因
[弧菌病]是由什么引起的	病因
[棘衣虫病]会出现什么	症状
[产后感染]是什么类型的疾病	类型
就患病部位来说[腹膜炎]是什么类型的疾病	类型
[风湿症]的类型是什么	类型
[紫杉]含有什么	有毒成分
[闹羊花]因此称什么	别名
[弧菌病]的病因多为什么	病因
[萱草]又被称为什么	别名
[肺坏疽]又叫什么	别名
就患病部位来说[癫瘸]是什么类型的疾病	类型
[断肠草]又被称为什么	别名
[产后瘫痪]的类型是什么	类型
[草木樨]是什么	别名
就患病部位来说[瓣胃阻塞]是什么类型的疾病	类型
[蒺藜]含有有毒的什么	有毒成分
就患病部位来说[坏瘟性肺炎]是什么类型的疾病	类型
[山羊皮肤组织细胞瘤病]的疾病类型是什么	类型
[闹羊花]什么成分毒性最强	有毒成分
[紫杉]有毒成分是什么	有毒成分
就患病部位来说[尿石症]是什么类型的疾病	类型
[小瓜虫病]的病原是什么	病因
[棘衣虫病]临床以什么为特征	症状
[鳃隐鞭虫病]是由什么引起的	病因
[侧殖吸虫病]有什么特征	症状
[鲤长棘吻虫病]是由什么引起的	病因
[腹膜炎]就患病部位来说属于什么类型的疾病	类型
[青冈]又被称为什么	别名
[青冈]的别称是什么	别名
[支气管炎]是一种什么疾病	类型
[蜡梅]又称	别名
[棘豆]是什么	别名
[变形虫病]主要表现出什么	症状
[真菌]什么成分毒性最强	有毒成分
[球状鳗居线虫病]是什么引起的疾病	病因
[鱼类爆发性出血病]的病原是什么	病因
请问[胸膜炎]的类型	类型
[尺蠖鱼蛭病]是什么导致的	病因
[土豆]什么成分毒性最强	有毒成分
[腹水]的疾病类型是什么	类型
[液膜性肠炎]的别名是什么	别名
[紫云英]又叫	别名
[马颈鱼鯴病]的病因多为什么	病因
[毒芹]有毒成分是什么	有毒成分
就患病部位来说[贫血]是什么类型的疾病	类型
[侧殖吸虫病]容易出现什么	症状
[倭病]属于什么病	类型
[蜡梅]又被称为什么	别名
[鲤蠢绦虫病]会有什么样的情况	症状
[变形虫病]会出现什么病症	症状
[产后瘫痪]的疾病类型是什么	类型
[紫云英]含毒性的部分是什么	有毒成分
[萱草]又叫	别名
[羔羊水中毒]的类型是什么	类型
造成[尺蠖鱼蛭病]的原因	病因
[中华鳋病]的病因多为什么	病因
[线麻]又叫	别名
[紫云英]是什么	别名
[鲤蠢绦虫病]呈现出什么	症状
[毒蛋白]什么成分有毒	有毒成分
[萱草]又称	别名
[荞麦]有毒成分是什么	有毒成分
[线麻]的别名是什么	别名
[腐鳍病]是由什么引起的	病因
[黏体虫病]的病因是什么	病因
[钻缺乏症]的类型是什么	类型
[变形虫病]是由什么引起的	病因
[膀脱炎]属于什么类型的疾病	类型
[四极虫病]是由什么引起的	病因
[蒺藜]的俗称是什么	别名
[线麻]含有有毒的什么	有毒成分
[腹膜炎]是一种什么疾病	类型
[土豆]又叫什么	别名
[腹膜炎]的类型是什么	类型
[鲤蠢绦虫病]主要表现为	症状
[膀脱炎]的类型是什么	类型
[烂鳃病]的病因是什么	病因
[棘衣虫病]致使什么	症状
[腐鳍病]的病因是什么	病因
[尿石症]的类型	类型
[蓖麻]含毒性的部分是什么	有毒成分
[山羊皮肤组织细胞瘤病]就患病部位来说属于什么类型的疾病	类型
[尾孢虫病]是什么导致的	病因
[蚜虫]又被称为什么	别名
[变形虫病]伴随着	症状
[草木樨]俗称什么	别名
[毒蛋白]的别称是什么	别名
[鲤蠢绦虫病]主要以什么为主	症状
[水稻二茬苗]什么成分有毒	有毒成分
造成[鲢碘泡虫病]的原因	病因
[羊鼻蝇蛆病]是一种什么疾病	类型
[蜡梅]又叫	别名
[鳃隐鞭虫病]是什么引起的疾病	病因
[肾炎]属于什么类型的疾病	类型
[蜡梅]因此称什么	别名
[马颈鱼鯴病]的病原是什么	病因
[禽巴氏杆菌病]有什么	疾病分类
[蜡梅]的别名是什么	别名
[棉花叶]什么成分有毒	有毒成分
[肠炎病]是由什么引起的	病因
[胸膜炎]的类型是什么	类型
[黏体虫病]的病因是什么	病因
请问[膀脱炎]的类型	类型
[小瓜虫病]的病因是什么	病因
[蒺藜]又称	别名
[羔羊癫痫]属于什么病	类型
[侧殖吸虫病]有什么症状	症状
[肺坏疽]是什么	别名
[草木樨]因此称什么	别名
[棘衣虫病]可能会怎么样	症状
[鲤蠢绦虫病]可能引起什么	症状
[刺槐]有毒成分是什么	有毒成分
请问[膀胧麻痹]的类型	类型
[鲤长棘吻虫病]可能会怎么样	症状
[鲤长棘吻虫病]主要表现为	症状
[羊虱虫病]的类型	类型
就患病部位来说[膀胧麻痹]是什么类型的疾病	类型
[紫云英]什么成分有毒	有毒成分
[尿石症]的类型是什么	类型
[萱草]又被称为什么	别名
[高梁二茬苗]含有什么	有毒成分
[紫茎泽兰]什么成分有毒	有毒成分
[灰灰菜]又叫什么	别名
[癫瘸]是什么	类型
[腹膜炎]是什么	类型
[鲢碘泡虫病]是什么导致的	病因
[毒蛋白]又被称为什么	别名
[脑膜脑炎]的类型	类型
[腹膜炎]的疾病类型是什么	类型
[车轮虫病]是什么导致的	病因
[水稻二茬苗]有毒是因为含有什么	有毒成分
[口腔炎]的类型是什么	类型
[鲤蠢绦虫病]的病原是什么	病因
[禽大肠杆菌病]属于什么类型	疾病分类
[鱼类爆发性出血病]是什么导致的	病因
[蚜虫]又叫	别名
[醉马草]什么成分毒性最强	有毒成分
[羊鼻蝇蛆病]就患病部位来说属于什么类型的疾病	类型
[鲤长棘吻虫病]的临床表现为什么	症状
[羔羊痢]属于什么病	类型
[四极虫病]的病因多为什么	病因
